0001111111111111111111111111111111111111111111111111111111111111111111111111111111111111111111111111
0000111111111111111111111111111111111111111111111111111111111111111111111111111111111111111111111111
0000000100000000000010000010000100100000000000001011110000000000100000000000000100000001000000000011
1000000100000000100010000010000000100000011110011010010000000000100000000000000100000001000000000011
1100000111111100100010000000000000000000011110011010010000011100100000111111100111111001000000000011
1111000000000000100010000000010000111110011110011010010000010000100000100000100100000000000000000011
1101001111111100100011111110010000100000011110011010010000010000100000100100100100000000000000000011
1101001000000000100000000000011100100000011110011110011110010000111100100111100000100000000000000011
1101001000000000100000000000010000100100011110001000000000010000000000100000000000111111111001111111
1101001000000000100000000000010000100100000000001000000000010000000000100000000000100000000000000011
1101001111111100100011111111111111111111111111111111111111111111111111111111111111110000111110000011
1100000010000000000000000000000000000000000000001000000000000000000000000000000000010000000010000011
1111110010000000000000000000000000000000000000001000000000000000000000000000000000010000000011110011
1100000010000000010010010001111111111111111111111111111111111111111111111111001110011111100010000011
1100111111111110010010010000000000000000000000001000000000000000000000000000000010010000000010000011
1100000000100000010010010000000000000000000000001000000000000000000000000000000010010000000010001111
1100000000100000010010010001111111111111111111111111001111111111111111111111110010010001111110000011
1111111100100000010010010001000000000000000000001000000000000000000000000000010010010000000010000011
1100000100100000010010010001000000000000000000001000000000000000000000000000010010010000000011110011
1100111100100000010010010001001111111111111111111111111111111111111111111110010010011111100010000011
1100010000000000010010010001001000000000000000001000000000000000000000000010010010010000000010000011
1101010000000000010010010001001000000000000000001000000000000000000000000010010010010000000010001111
1101000000000000010010010001001001111111111111111111111111111111111111110010010010010001111110000011
1101111111111111110010010001001001000000000000001000000000000000000000010010010010010000000010000011
1101001000000000010010010001001001001111111111111111111111111111111110010010010010010000000011110011
1101001000000000010010010001001001000000000000001000000000000000000010010000010010011111100010000011
1101001000000000010010010001001001000000000000001000000000000000000010010000010010010000000010000011
1100001111111100010010010001001001111111111111111111111111111111111110010010010010010000000010001111
1111001000000000010010010001001000000000000000001000000000000000000000010010010010010001111110000011
1101001000001000010010010001001000000000000000001000000000000000000000010010010010010000000010000011
1101001111001000010010010001001111111111111111111111111111111111111111110010010010010000000011110011
1101000000001111110010010001000000000000000000001000000000000000000000000010010010011111100010000011
1100000000001001010010010001000000000000000000001000000000000000000000000010010010010000000010000011
1100000000001001010010010001111111111111111111111111111111111111111111111110010010010000000010001111
1111111110001001010010010000000000000000000000001000000000000000000000000000010010010000000010000011
1100000000000001010010010000000000000000000000001000000000000000000000000000010010011111000010000011
1100000000100000010010011111111111111111111111111111111111111111111111111111110010010001000011110011
1100011100100000010010000000000000000000000000001000000000000000000000000000000010010001000010000011
1111110000100000010010000000000000000000000000001000000000000000000000000000000010010001001110001111
1100000000111100010011111111111111111111111111111111111111111111111111111111111110010011000010000011
1100001100100000010000000000000000000000000000001000000000000000000000000000000000010010000010000011
1100001000100011111111111111111111111111111111111111111111111111111111111111111111110010000010000011
1100001000100000000000000000000000000000000000000000000000000000000000000000000000000010010010000011
1100001000111100000000000000000000000000000000000000000000000000000000000000000000000000010000000011
1100111000100000000000000000000000000000000000000000000000000000000000000000000000000000010000000011
1100001000100000000000000000000000000000000000000000000000000000000000000000000000000000010000000011
1100001000111111111111111111111111111111111111111111111111111111111111111111111111111111111100001111
1100001000100000000000000000000010000000000000000000000000000000000000000000000000000000000000000011
1111111111100000000000000000000010000000000000000000000000000000000000000000000000000000000000000011
1100100000000000000000000000000010001111000111100011110001111000111100011110001000100001111111111111
1100100000000000000000000000100010001001000100100010010001001000100100010010001000100001111111111111
1100100111111111111111111000100010001001000100100010010001001000100100010010001000100001111111111111
1100100100000000000000001000100010001001000100100010010001001000100100010010001000100001000000000011
1100100100000000000000001000100010001001000100100010010001001000100100010010001000100001000000000011
1100000100111111111111001000100010001001000100100010010001001000100100010010001000100001001111100011
1100000100100000000001001000100010001001000100100010010001001000100100010010001000100001001000100011
1100000100100000000001001000100010001001000100100010010001001000100100010010001000100001001110100011
1100000100100111111001001000100010001001000100100010010001001000100100010010001000100001000000100011
1100000100100100001001001000100010001001000100100010010001001000100100010010001000100001000000100011
1100000100100100101001001000100011111001111100111110011111001111100111110011111000100001111111100011
1100000100100100101001001000100000000000000000000000000000000000000000000000000000000000000000000011
1100000100100100111001001000100000000000000000000000000000000000000000000000000000000000000000000011
1100000100100100000001001000100111111111111111111111111111111111111111111111111111111111111111100011
1100000100100100000001001000100000000000000000000000000000000000000000000000000000000000000000000011
1100000100100111111111001000100000000000000000000000000000000000000000000000000000000000000000000011
1100000100100000000000001000100011111001111100111110011111001111100011110001111000111100011110000011
1100000100100000000000001000100010001001000100100010010001001000100010010001001000100100010010000011
1100000100111111111111111000100010001001000100100010010001001000100010010001001000100100010010000011
1100000100000000000000000000100010001001000100100010010001001000100010010001001000100100010010000011
1100000100000000000000000000100010001001000100100010010001001000100010010001001000100100010010000011
1100000111111111111111111111100010001001000100100010010001001000100010010001001000100100010010000011
1100000000000000000000000000000010001001000100100010010001001000100010010001001000100100010010000011
1100000000000000000000000000000010001001000100100010010001001000100010010001001000100100010010000011
1100000000000000000000000000000010001111000100100010010001001000100010010001001000100100010010000011
1100000000000000000000000000000010000000000100100010010001001000100010010001001000100100010010000011
1100000111111111111111111111111110000000000111100011110001111000111110011111001111100111110011111111
1100000100000000000000000000000010000000000000000000000000000000000000000000000000000000000000000011
1111100100000000000000000000000010000000000000000000000000000000000000000000000000000000000000000011
1100000100000000000000000000000010001111111111111111111111000000000000001111111111111111000000000011
1100000100000000000000000000000010001000000000000000000000000000000000000000000000000001000111110011
1100000100000000000000000000000010001000000000000000000000000000000000000000000000000001000100000011
1100111100000000000000000000000010001000011111111111111111111111111111111111111111111001000100000011
1100000100000000000000000000000010001000010000000000000000000000000000000000000000001001000100111111
1100000100000000000000000000000010001000010000000000000000000000000000000000000000001001000100000011
1111100100000000000000000000000010001000010011111111111111111111111111111111111111001001000100000011
1100000100000000000000000000000010001000010010000000000000000000000000000000000001001001000111110011
1100000100000000000000000000000010001000010010000000000000000000000000000000000001001001000100000011
1100111100000000000000000000000010001000010010011111111111111111111111111111110001001001000100000011
1100000100000000000000000000000010000000010010010000000000000000000000000000000001001001000100111111
1100000100000000000000000000000010000000010010011111111111111111111111111111111111001001000100000011
1111100100000000000000000000000010000000010010000000000000000000000000000000000000001001000100000011
1100000100000000000000000000000010001110010010000000000000000000000000000000000000001001000111110011
1100000100000000000000000000000010001110010011111111111111111111111111111111111111111001000100000011
1100111100000000000000000000000010001110010000000000000000000000000000000000000000000001000100000011
1100000000000000000000000000000000001110010000000000000000000000000000000000000000000001000100000011
1100000000000000000000000000000000001110011111111111111111111111111111111111111111111111000100000011
1111100000000000000000000000000000001110000000000000000001000000000000000000000000000000000100000011
1100000000000000000000000000000000001110000000000000000001000000000000000000000000000000000100000011
1111111111111111111111111111111111111111111111111111111111111111111111111111111111111111111111111111
1111111111111111111111111111111111111111111111111111111111111111111111111111111111111111111111111111
